{
  "name": "stage1",

  "theme": {
    "tile": "minecraft",
    "background": "snu"
  },

  "player": [
    {
      "pos": [ 30.0, 40.0 ]
    },
    {
      "pos": [ 290.0, 40.0 ]
    }
  ],

  "enemy": [
    {
      "name": "enemy1",
      "pos": [ 80.0, 40.0 ]
    },
    {
      "name": "enemy1",
      "pos": [ 240.0, 140.0 ]
    }
  ],

  "tile": [
    "########...##########...########",
    "########...##########...########",
    "########...##########...########",
    "########...##########...########",
    "########...##########...########",
    "##............................##",
    "##............................##",
    "##............................##",
    "##........############........##",
    "##............................##",
    "##............................##",
    "##............................##",
    "########................########",
    "##............................##",
    "##............................##",
    "##............................##",
    "##.....#................#.....##",
    "##.....#.##############.#.....##",
    "##............................##",
    "##............................##",
    "##............................##",
    "#########..............#########",
    "##............................##",
    "##............................##",
    "##............................##",
    "##.........##########.........##",
    "##............................##",
    "##............................##",
    "##............................##",
    "########...##########...########",
    "########...##########...########",
    "########...##########...########"
  ],

  "bubble_current": [
    "DDDDDDDDDDDDDDDDDDDDDDDDDDDDDDDD",
    "DDDDDDDDDDDDDDDDDDDDDDDDDDDDDDDD",
    "DDDDDDDDDDDDDDDDDDDDDDDDDDDDDDDD",
    "DDDDDDDDDDDDDDDDDDDDDDDDDDDDDDDD",
    "DDDDDDDDDDDDDDDDDDDDDDDDDDDDDDDD",
    "RRRRRRRRRRDDLLLLRRRRDDLLLLLLLLLL",
    "RR........DD........DD........LL",
    "RR........DD........DD........LL",
    "RR........DD........DD........LL",
    "RR........DD........DD........LL",
    "RR........DD........DD........LL",
    "RR........DD........DD........LL",
    "RR........DD........DD........LL",
    "RR........DD........DD........LL",
    "RR........DD........DD........LL",
    "RR.......LLRR......LLRR.......LL",
    "RR.......LLRR......LLRR.......LL",
    "RR............................LL",
    "RR............................LL",
    "RR............................LL",
    "RR............................LL",
    "RR..........LLLLRRRR..........LL",
    "RR............................LL",
    "RR............................LL",
    "RR............................LL",
    "RR............................LL",
    "RR............................LL",
    "RR............................LL",
    "RR............................LL",
    "RR............................LL",
    "RR............................LL",
    "RR............................LL"
  ]
}